5 5 5 5 5 5 5 5 5 5 5 5 5 5 5 5 5 5 5 5
5 5 5 5 5 5 5 5 5 5 5 5 5 5 5 5 5 5 5 5
5 5 4 4 4 4 4 4 4 4 4 4 4 4 4 4 4 4 5 5
0 1 2 3 4 5 6 7 8 9 10 11 12 13 14 15 16 17 1 1 1
5 5 2 2 2 2 2 2 2 2 2 2 2 2 3 4 4 4 5 5
5 5 3 3 3 3 3 3 3 3 3 3 3 2 3 4 4 4 5 5
5 5 4 4 4 4 3 3 3 3 3 3 3 2 3 4 4 4 5 5
5 5 4 4 4 4 3 2 2 2 2 2 2 2 3 4 4 4 5 5
5 5 4 4 4 4 3 2 3 3 3 3 3 3 3 4 4 4 5 5
5 5 4 4 4 4 3 2 3 4 4 4 4 4 4 4 4 4 5 5
5 5 4 4 4 4 3 2 3 3 3 3 3 3 3 3 3 4 5 5
5 5 4 4 4 4 3 2 2 2 2 2 2 2 2 2 2 4 5 5
5 5 4 4 4 4 3 3 3 3 3 3 3 3 2 3 3 4 5 5
5 5 4 4 4 4 4 4 4 4 4 4 4 3 2 3 4 4 5 5
5 5 4 4 4 4 4 4 4 4 4 4 4 3 2 3 4 4 5 5
5 5 4 4 4 4 4 4 4 4 4 4 4 3 2 3 4 4 5 5
5 5 4 4 4 4 4 4 4 4 4 4 4 3 2 3 4 4 5 5
5 5 4 4 4 4 4 4 4 4 4 4 4 3 2 3 4 4 5 5
5 5 5 5 5 5 5 5 5 5 5 5 5 5 2 5 5 5 5 5
5 5 5 5 5 5 5 5 5 5 5 5 5 5 5 5 5 5 5 5


